NO ./assets/wall1.xpm
SO ./assets/wall2.xpm
WE ./assets/wall3.xpm
EA ./assets/wall4.xpm

C 125,159,0
F 255,255,203

 1111111111111111111111
100000000000000000000001
 1000000000000000000001
  10000000000000000001
   100000000000000001
    10000000N0000001
     10000000000001
      100000000001
       1000000001
        10000001
         101101
          1001
           11